0   0   0   0   0   0   0   0   0   0   0   0   0   0   0   0   0   0   0   
0   0   0   0   0   0   0   0   0   0   0   0   0   0   0   0   0   0   0   
0   16  17  18  19  20  21  0   35  34  33  32  0   0   0   0   0   0   0   
0   15  0   0   0   0   0   0   0   0   0   31  0   0   0   0   50  51  52  
0   14  13  12  11  0   25  26  27  28  29  30  31  32  33  0   49  0   0   
0   0   0   0   10  0   24  0   0   0   0   31  0   0   34  0   48  0   0   
0   12  0   0   9   0   23  22  21  20  0   32  0   0   35  0   47  0   0   
0   11  0   0   8   0   0   0   0   19  0   33  0   0   36  0   46  0   0   
0   10  9   8   7   8   9   0   0   18  0   34  0   0   37  0   45  46  0   
0   0   0   0   6   0   10  0   0   17  0   0   0   0   38  0   44  0   0   
1   2   3   4   5   0   11  0   0   16  0   0   0   0   39  0   43  0   0   
0   0   0   0   0   0   12  13  14  15  0   0   0   0   40  41  42  0   0   
0   0   0   0   0   0   0   0   0   0   0   0   0   0   0   0   0   0   0   
