XXXXXXXXXXXXXXXXXXX
XXXXXXXXXXXXXXXXXXX
XOOOOOOXOOOOXXXXXXX
XOXXXXXXXXXOXXXXOOO
XOOOOXOOOOOOOOOXOXX
XXXXOXOXXXXOXXOXOXX
XOXXOXOOOOXOXXOXOXX
XOXXOXXXXOXOXXOXOXX
XOOOOOOXXOXOXXOXOOX
XXXXOXOXXOXXXXOXOXX
OOOOOXOXXOXXXXOXOXX
XXXXXXOOOOXXXXOOOXX
XXXXXXXXXXXXXXXXXXX